A:-;C;F;-;-;
B:-;-;C;-;-;
C:B;D;G;A;H;
D:-;E;-;C;-;
E:-;-;-;D;-;
F:-;-;J;-;K;
G:C;-;-;-;-;
H:-;I;L;-;M;
I:-;-;-;H;-;
J:F;-;-;-;-;
K:L;-;-;-;-;
L:H;-;K;-;-;
M:N;-;-;-;H;
N:-;-;S;-;-;
start:A;
finish:N;
